1,2,1,2,1,2,1,2,1,2,1,2,1,2,1,2
2,4,0,0,0,0,0,0,0,0,0,0,0,0,3,1
1,0,0,0,0,H,H,H,H,H,H,0,0,0,0,2
2,0,0,0,0,0,0,0,0,0,0,0,0,0,0,1
1,0,0,0,0,0,0,0,0,0,0,0,0,0,0,2
2,0,H,0,0,0,0,1,0,0,0,0,0,H,0,1
1,0,H,0,0,0,0,H,H,0,0,0,0,H,0,2
2,0,H,0,0,0,0,H,H,0,0,0,0,H,0,1
1,0,H,0,0,0,0,0,0,0,0,0,0,H,0,2
2,0,0,0,0,0,0,0,0,0,0,0,0,0,0,1
1,0,0,0,0,0,0,0,0,0,0,0,0,0,0,2
2,0,0,0,0,H,H,H,H,H,H,0,0,0,0,1
1,3,0,0,0,0,0,0,0,0,0,0,0,0,4,2
2,1,2,1,2,1,2,1,2,1,2,1,2,1,2,1
