X,X,X,X,X,X,X,X,X,X,X,X,X,X,X,X
X,X,0,0,0,0,0,0,0,0,0,0,0,0,X,X
X,0,0,0,0,0,0,0,0,0,0,0,0,0,0,X
X,0,0,0,0,0,0,0,0,0,0,0,0,0,0,X
X,0,0,0,0,0,0,0,0,0,0,0,0,0,0,X
X,0,0,0,0,0,0,0,0,0,0,0,0,0,0,X
X,0,0,0,0,0,0,0,0,0,0,0,0,0,0,X
X,0,0,0,0,0,0,0,0,0,0,0,0,0,0,X
X,0,0,0,0,0,0,0,0,0,0,0,0,0,0,X
X,0,0,0,0,0,0,0,0,0,0,0,0,0,0,X
X,0,0,0,0,0,0,0,0,0,0,0,0,0,0,X
X,0,0,0,0,H,H,H,H,0,0,0,0,0,0,X
X,X,0,0,0,0,0,0,0,0,0,0,0,0,X,X
X,X,X,X,X,X,X,X,X,X,X,X,X,X,X,X